12 12 12 12 12 12 12 12 12 12 12 12 12 26 21 11 10 10 10 10 10 10 10 10 10 10 10 10 10 10 10 11 10 10 10 10 10 10 10 10 10 10 10 10 10 10 10 10 10 10
12 12 12 12 12 12 12 12 12 12 12 26 20 21 10 11 10 10 10 10 10 10 10 10 10 10 10 10 10 10 10 11 10 10 10 10 10 10 10 10 10 10 10 10 10 10 10 10 10 10
12 12 12 12 12 12 12 12 12 26 20 21 10 10 10 11 10 10 10 10 17 16 16 16 16 16 23 10 10 10 10 11 10 10 10 10 10 10 10 10 10 10 10 10 10 10 10 10 10 10
12 12 12 12 12 12 12 12 26 21 10 10 10 10 10 11 10 10 10 10 18 12 12 12 12 12 22 10 10 10 10 11 10 10 10 10 10 10 10 10 10 10 10 10 10 10 10 10 10 10
12 12 12 12 12 12 12 26 21 10 10 10 10 10 10 11 10 10 10 10 18 12 12 12 12 12 22 10 10 10 10 11 10 10 10 10 10 10 10 10 10 10 10 10 10 10 10 10 10 10
12 12 12 12 26 20 20 21 10 10 10 10 10 10 10 11 10 10 10 10 18 12 12 12 12 12 22 10 10 10 10 11 10 10 10 10 10 10 10 10 10 10 10 10 10 10 10 10 10 10
12 12 12 26 21 10 10 10 10 10 10 10 10 10 10 11 10 10 10 10 19 20 20 20 20 20 21 10 10 10 10 11 10 10 10 10 10 10 10 10 10 10 10 10 10 10 10 10 10 10
12 12 12 22 10 10 10 10 10 10 10 10 10 10 10 11 10 10 10 10 10 10 10 10 10 10 10 10 10 10 10 11 10 10 10 10 10 10 10 10 10 10 10 10 10 10 10 10 10 10
12 12 26 21 10 10 10 10 10 10 10 10 10 10 10 11 10 10 10 10 10 10 10 10 10 10 10 10 10 10 10 11 10 10 10 10 10 10 10 10 10 10 10 10 10 10 10 10 10 10
12 12 22 10 10 10 10 10 10 10 10 10 10 10 10 11 10 10 10 10 10 10 10 13 10 10 10 10 10 10 10 11 10 10 10 10 10 10 10 10 10 10 10 10 10 10 10 10 10 10
12 26 21 10 10 10 10 10 10 10 10 10 10 10 10 11 11 11 11 11 11 11 11 13 11 11 11 11 11 11 11 11 10 10 10 10 10 10 10 10 10 10 10 10 10 10 10 10 10 10
12 22 10 10 10 10 10 10 10 10 10 10 10 10 10 10 10 10 10 10 10 10 13 13 13 10 10 10 10 10 10 10 10 10 10 10 10 10 10 10 10 10 10 10 10 10 10 10 10 10
26 21 10 10 10 10 10 10 10 10 10 10 10 10 10 10 10 10 10 10 10 10 13 13 13 10 10 10 10 10 10 10 10 10 10 10 10 10 10 10 10 10 10 10 10 10 10 10 10 10
21 10 10 10 10 10 10 10 10 10 10 13 13 13 13 13 13 13 13 13 13 13 13 13 13 13 13 13 13 13 13 13 13 13 13 13 13 13 13 13 13 13 13 13 13 13 13 13 10 10
10 10 10 10 10 10 10 10 10 10 10 13 13 13 13 13 13 13 13 13 13 13 13 13 13 13 13 13 13 13 13 13 13 13 13 13 13 13 13 13 13 13 13 13 13 13 13 13 10 10
10 10 10 10 10 10 10 10 10 10 10 10 10 10 10 10 10 11 13 11 11 11 11 11 11 11 10 10 10 10 10 10 10 10 10 10 10 10 10 10 10 10 10 10 10 10 10 10 10 10
10 10 10 10 10 10 10 10 10 10 10 10 10 10 10 10 10 11 13 13 13 13 13 13 13 11 10 10 10 10 10 10 10 10 10 10 10 10 10 10 10 10 10 10 10 10 10 10 10 10
10 10 10 10 10 10 10 10 10 10 10 10 10 10 10 10 11 11 11 11 11 11 11 11 13 11 11 11 11 11 11 10 10 10 10 10 10 10 10 10 10 10 10 10 10 10 10 10 10 10
10 10 10 10 10 10 10 10 10 10 10 10 10 10 10 10 11 13 13 13 13 13 13 13 13 11 13 13 13 13 11 10 10 10 10 10 10 10 10 10 10 17 16 16 23 10 10 10 10 10
11 11 11 11 11 11 11 11 11 10 10 10 10 10 10 10 11 13 11 11 11 11 11 11 11 11 13 11 11 13 11 10 10 10 10 10 10 10 10 10 10 18 12 12 22 10 10 10 10 10
11 13 13 13 13 13 13 13 11 10 10 10 10 10 10 10 11 13 11 13 13 13 13 13 13 13 13 11 11 13 10 10 10 10 10 10 10 10 10 10 10 18 12 12 22 10 10 10 10 10
11 13 13 13 13 13 13 13 13 10 10 10 10 10 10 10 11 13 11 13 11 11 11 11 11 11 11 11 11 11 11 10 10 10 10 10 10 10 17 16 16 24 12 12 27 16 16 23 10 10
11 13 13 13 13 13 13 13 11 17 16 23 10 10 10 10 11 13 11 13 13 13 13 13 13 13 13 13 13 13 11 10 10 10 10 10 10 10 18 12 12 12 12 12 12 12 12 22 10 10
11 11 11 11 13 11 11 11 11 19 20 21 10 10 10 10 11 13 11 11 11 11 11 11 11 11 11 11 11 13 11 10 10 10 10 10 10 10 19 20 20 25 12 12 26 20 20 21 10 10
11 13 13 13 13 13 13 13 13 10 10 10 10 10 10 10 11 13 13 13 13 13 13 13 13 13 13 13 13 13 11 10 10 10 10 10 10 10 10 10 10 18 12 12 22 10 10 10 10 10
11 13 13 13 13 13 13 13 13 10 10 10 10 10 10 10 11 11 11 11 11 11 11 11 11 11 11 11 11 11 11 10 10 10 10 10 10 10 10 17 16 24 12 12 27 16 23 10 10 10
11 11 11 11 13 11 11 11 11 17 16 23 10 10 10 10 10 10 10 10 10 10 10 10 10 10 10 10 10 10 10 10 10 10 10 10 10 10 10 18 12 12 12 12 12 12 22 10 10 10
11 13 13 13 13 13 13 13 11 19 20 21 10 10 10 10 10 10 10 10 10 10 10 10 10 10 10 10 10 10 10 10 10 10 10 10 10 10 10 19 20 25 12 12 26 20 21 10 10 10
11 13 13 13 13 13 13 13 13 10 10 10 10 10 10 10 10 10 10 10 10 10 10 10 10 10 10 10 10 10 10 10 10 10 10 10 10 10 10 10 10 18 12 12 22 10 10 10 10 10
11 13 13 13 13 13 13 13 11 10 10 10 10 10 10 10 10 10 10 10 10 10 10 10 10 10 10 10 10 10 10 10 10 10 10 10 10 10 10 10 10 18 12 12 22 10 10 10 10 10
11 11 11 11 11 11 11 11 11 10 10 10 10 10 10 10 10 10 10 10 10 10 10 13 10 10 10 10 10 10 10 10 10 10 10 10 10 10 10 10 10 18 12 12 22 10 10 10 10 10
23 10 10 10 10 10 10 10 10 10 10 10 10 10 10 10 10 10 10 10 10 10 13 13 13 10 10 10 10 10 10 10 10 10 10 10 10 10 10 10 10 18 12 12 22 10 10 10 10 10
22 10 10 10 10 10 10 10 10 10 10 10 10 10 10 10 10 10 10 10 10 10 13 13 13 10 10 10 10 10 10 10 10 10 10 10 10 10 10 10 10 18 12 12 22 10 10 10 10 10
27 23 10 10 10 10 10 10 10 10 10 10 10 10 10 10 10 10 10 10 10 10 13 13 13 10 10 10 10 10 10 10 10 10 10 10 10 10 10 10 10 18 12 12 22 10 10 10 10 10
12 22 10 10 10 10 10 10 10 10 10 10 10 10 10 10 10 10 10 10 10 10 13 13 13 10 10 10 10 10 10 10 10 10 10 10 10 10 10 10 10 18 12 12 22 10 10 10 10 10
12 22 10 10 10 10 10 10 10 10 10 10 10 10 10 10 10 10 10 10 10 11 13 13 13 11 10 10 10 10 10 10 10 10 10 10 10 10 10 10 10 18 12 12 22 10 10 10 10 10
12 27 16 16 16 16 16 16 16 16 16 16 16 16 16 16 16 16 16 16 16 11 13 13 13 11 16 16 16 16 16 16 16 16 16 16 16 16 16 16 16 24 12 12 27 16 16 16 16 16
12 26 20 20 20 20 20 20 20 20 20 20 20 20 20 20 20 20 20 20 20 11 13 13 13 11 20 20 20 20 20 20 20 20 20 20 20 20 20 20 20 20 20 20 20 20 20 25 12 12
12 22 10 10 10 10 10 10 10 10 10 10 10 10 10 10 10 10 10 10 10 11 13 13 13 11 10 10 10 10 10 10 10 10 10 10 10 10 10 10 10 10 10 10 10 10 10 18 12 12
12 27 16 23 10 10 10 10 10 10 10 10 10 10 10 10 10 10 10 10 10 10 13 13 13 10 10 10 10 10 10 10 10 10 10 10 10 10 10 10 10 10 10 10 10 10 17 24 12 12
12 12 12 22 10 10 10 10 10 10 10 10 10 10 10 10 10 10 10 10 10 10 13 13 13 10 10 10 10 10 10 10 10 10 10 10 10 10 10 10 10 10 10 10 10 10 18 12 12 12
12 12 12 27 16 23 10 10 10 10 10 10 10 10 10 10 10 10 10 10 10 10 13 13 13 10 10 10 10 10 10 10 10 10 10 10 10 10 10 10 10 10 10 10 10 10 18 12 12 12
12 12 12 12 12 22 10 10 10 10 10 10 10 10 10 10 10 10 10 10 10 10 10 13 13 13 10 10 10 10 10 10 10 10 10 10 10 10 10 10 10 10 10 10 10 17 24 12 12 12
12 12 12 12 12 27 23 10 10 10 10 10 10 10 10 10 10 10 10 10 10 10 10 13 13 13 10 10 10 10 10 10 10 10 10 10 10 10 10 10 10 10 10 10 17 24 12 12 12 12
12 12 12 12 12 12 27 23 10 10 10 10 10 10 10 10 10 10 10 10 10 10 10 10 13 13 13 10 10 10 10 10 10 10 10 10 10 10 10 10 10 10 10 17 24 12 12 12 12 12
12 12 12 12 12 12 12 27 16 23 10 10 10 10 10 10 10 10 10 10 10 10 10 10 10 13 13 13 10 10 10 10 10 10 10 10 10 10 10 10 10 10 10 18 12 12 12 12 12 12
12 12 12 12 12 12 12 12 12 27 16 16 23 10 10 10 10 10 10 10 10 10 10 10 10 10 13 13 13 13 10 10 10 10 10 10 10 10 10 10 10 10 17 24 12 12 12 12 12 12
12 12 12 12 12 12 12 12 12 12 12 12 27 16 16 23 10 10 10 10 10 10 10 10 10 10 10 13 13 13 13 13 13 10 10 10 10 10 10 10 10 17 24 12 12 12 12 12 12 12
12 12 12 12 12 12 12 12 12 12 12 12 12 12 12 27 16 16 16 23 10 10 10 10 10 10 10 10 13 13 13 13 13 13 13 13 10 10 10 17 16 24 12 12 12 12 12 12 12 12
12 12 12 12 12 12 12 12 12 12 12 12 12 12 12 12 12 12 12 27 16 16 16 23 10 10 10 10 10 10 13 13 13 13 13 13 10 17 16 24 12 12 12 12 12 12 12 12 12 12
