15 15 10 32 32 32 32 32 32 32 32 32 32 10 10 11 10 10 10 10 10 10 10 10 10 10 10 10 10 10 10 11 10 10 10 15 15 15 15 15 15 15 15 15 15 15 15 15 15 15
15 10 34 14 14 14 14 14 14 14 14 14 14 30 10 11 10 10 10 10 10 10 10 10 10 10 10 10 10 10 10 11 10 10 10 15 15 15 15 15 15 15 15 15 15 15 15 15 15 15
15 10 34 14 14 14 14 14 14 14 14 14 14 30 10 11 10 10 10 17 16 16 16 16 16 16 16 23 10 10 10 11 10 10 10 15 15 14 14 14 14 14 14 14 14 14 14 14 15 15
15 15 10 28 28 28 28 28 28 28 35 14 14 30 10 11 10 10 10 18 12 12 12 12 12 12 12 22 10 10 10 11 10 10 10 15 15 14 15 15 15 15 15 15 15 15 15 14 15 15
15 15 15 15 15 10 10 10 10 10 34 14 14 30 10 11 10 10 10 18 12 12 12 12 12 12 12 22 10 10 10 11 10 10 10 15 15 14 15 14 14 14 14 14 14 14 15 14 15 15
15 15 15 15 15 15 15 10 10 10 34 14 14 30 10 11 10 10 10 18 12 12 12 12 12 12 12 22 10 10 10 11 10 10 10 15 15 14 15 14 15 15 15 15 15 14 15 14 15 15
15 15 15 15 15 15 15 10 10 10 34 14 14 30 10 11 10 10 10 19 20 20 20 20 20 20 20 21 10 10 10 11 10 10 10 15 15 14 15 14 15 14 10 14 15 14 15 14 15 15
15 15 15 15 15 15 15 15 10 10 34 14 14 30 10 11 10 10 10 10 10 10 10 10 10 10 10 10 10 10 10 11 10 10 10 15 15 14 15 14 14 14 14 14 15 14 15 14 15 15
15 15 15 15 15 15 15 15 10 10 34 14 14 30 10 11 10 10 10 10 10 10 10 10 10 10 10 10 10 10 10 11 10 10 10 15 15 14 15 15 15 15 15 15 15 14 15 14 15 15
15 15 15 15 15 15 15 15 10 10 34 14 14 30 10 11 10 10 10 10 10 10 10 14 10 10 10 10 10 10 10 11 10 10 10 15 15 14 14 14 14 14 14 14 14 14 15 14 15 15
15 15 15 15 15 15 15 15 10 10 34 14 14 30 10 11 11 11 11 11 11 11 11 14 11 11 11 11 11 11 11 11 10 10 10 15 15 15 15 15 15 15 15 15 15 15 15 14 15 15
15 15 15 15 15 15 15 15 10 10 34 14 14 30 10 10 10 10 10 10 10 34 14 14 14 30 10 10 10 10 10 10 10 10 10 15 15 15 15 15 15 15 15 15 15 15 15 14 15 15
15 15 15 15 15 15 15 15 10 10 34 14 14 31 32 32 32 32 32 32 32 33 14 14 14 31 32 32 32 32 32 32 32 32 32 32 32 32 32 32 32 32 32 32 32 32 33 14 30 15
15 15 15 15 15 15 15 15 10 10 34 14 14 14 14 14 14 14 14 14 14 14 14 14 14 14 14 14 14 14 14 14 14 14 14 14 14 14 14 14 14 14 14 14 14 14 14 14 30 15
15 15 15 15 15 15 15 15 10 10 34 14 14 14 14 14 14 14 14 14 14 14 14 14 14 14 14 14 14 14 14 14 14 14 14 14 14 14 14 14 14 14 14 14 14 14 14 14 30 15
15 15 15 15 15 15 15 10 10 10 10 28 28 28 28 28 28 28 28 28 28 35 14 14 14 29 28 28 28 28 28 28 28 28 28 28 28 28 28 28 28 28 28 28 28 28 28 28 10 15
15 15 15 15 15 15 10 10 10 10 15 15 15 15 15 15 15 10 10 10 10 34 14 14 14 30 10 15 15 15 15 15 15 15 15 15 15 15 10 10 10 10 14 14 10 10 10 10 15 15
15 15 15 10 10 10 10 10 10 10 15 15 15 15 15 15 15 15 15 10 10 34 14 14 14 30 10 15 15 15 15 15 15 15 15 15 15 10 10 10 11 11 11 11 11 11 10 10 10 15
10 10 10 10 10 10 10 10 10 10 10 15 15 15 15 15 15 15 15 10 10 34 14 14 14 30 10 15 15 15 15 15 15 15 15 15 10 10 10 11 11 14 14 14 14 11 11 10 10 15
11 11 11 11 11 11 11 11 11 10 10 10 10 15 15 15 15 15 15 15 10 34 14 14 14 30 10 15 15 15 15 15 15 15 15 10 10 10 11 11 14 14 14 14 14 14 11 11 10 10
11 14 14 14 14 14 14 14 11 32 32 32 10 10 15 15 15 15 15 15 10 34 14 14 14 30 10 15 15 15 15 15 15 15 10 10 10 11 11 14 14 14 14 14 14 14 14 11 11 10
11 14 14 14 14 14 14 14 14 14 14 14 30 10 15 15 15 15 15 15 10 34 14 14 14 31 32 32 32 32 32 32 32 32 32 32 32 11 14 14 14 14 14 14 14 14 14 14 11 10
11 14 14 14 14 14 14 14 11 12 12 14 30 10 15 15 15 15 15 15 10 34 14 14 14 14 14 14 14 14 14 14 14 14 14 14 14 14 14 14 14 14 14 14 14 14 14 14 11 14
11 11 11 11 14 11 11 11 11 12 12 14 31 32 32 32 32 32 32 32 32 33 14 14 14 14 14 14 14 14 14 14 14 14 14 14 14 14 14 14 14 14 14 14 14 14 14 14 11 14
11 14 14 14 14 14 14 14 14 14 14 14 14 14 14 14 14 14 14 14 14 14 14 14 14 29 28 28 28 28 28 28 28 28 28 28 28 11 14 14 14 14 14 14 14 14 14 14 11 10
11 14 14 14 14 14 14 14 14 14 14 14 14 14 14 14 14 14 14 14 14 14 14 14 14 30 10 15 15 15 15 15 15 15 10 10 10 11 11 14 14 14 14 14 14 14 14 11 11 10
11 11 11 11 14 11 11 11 11 12 12 14 29 28 28 28 28 28 28 28 28 35 14 14 14 30 10 15 15 15 15 15 15 15 15 10 10 10 11 11 14 14 14 14 14 14 11 11 10 10
11 14 14 14 14 14 14 14 11 12 12 14 30 10 15 15 15 15 15 15 10 34 14 14 14 30 10 15 15 15 15 15 15 15 15 15 10 10 10 11 11 14 14 14 14 11 11 10 10 10
11 14 14 14 14 14 14 14 14 14 14 14 30 10 15 15 15 15 15 15 10 34 14 14 14 30 10 15 15 15 15 15 15 15 15 15 15 10 10 10 11 11 11 11 11 11 10 10 10 15
11 14 14 14 14 14 14 14 11 28 28 28 10 15 15 15 15 15 15 15 10 34 14 14 14 30 10 10 10 10 15 15 15 15 15 15 15 15 10 10 10 10 14 14 10 10 10 10 15 15
11 11 11 11 11 11 11 11 11 10 10 10 15 15 15 15 15 15 15 15 10 34 14 14 14 30 10 15 15 15 15 15 15 15 15 15 15 15 15 15 10 10 10 10 10 10 15 15 15 15
10 10 10 10 10 10 10 10 10 10 15 15 15 15 15 15 15 15 15 15 10 34 14 14 14 30 10 15 15 15 15 15 15 15 15 15 15 15 15 15 15 10 10 10 10 15 15 15 15 15
10 10 15 15 15 15 15 15 15 15 15 15 15 15 15 15 15 15 15 15 10 34 14 14 14 30 10 15 15 15 15 15 15 15 15 15 15 15 15 15 15 15 15 15 15 15 15 15 15 15
10 10 15 15 15 15 15 15 15 15 15 15 15 15 15 15 15 15 15 15 10 34 14 14 14 30 10 10 15 15 15 15 15 15 15 15 15 15 15 15 15 15 15 15 15 15 15 15 15 15
10 10 15 15 15 15 15 15 15 15 15 15 15 15 15 15 15 15 15 10 10 34 14 14 14 30 10 10 10 15 15 15 15 15 15 15 15 15 15 15 15 15 15 15 15 15 15 15 15 15
10 10 10 10 10 10 10 10 10 10 10 10 10 10 10 10 10 10 10 10 10 11 14 14 14 11 10 10 10 10 10 10 10 10 10 10 10 10 10 10 10 10 10 10 10 10 10 10 10 10
16 16 16 16 16 16 16 16 16 16 16 16 16 16 16 16 16 16 16 16 16 11 14 14 14 11 16 16 16 16 16 16 16 16 16 16 16 16 16 16 16 16 16 16 16 16 16 16 16 16
20 20 20 20 20 20 20 20 20 20 20 20 20 20 20 20 20 20 20 20 20 11 14 14 14 11 20 20 20 20 20 20 20 20 20 20 20 20 20 20 20 20 20 20 20 20 20 20 20 20
10 10 10 10 10 10 10 10 10 10 10 10 10 10 10 10 10 10 10 10 10 11 14 14 14 11 10 10 10 10 10 10 10 10 10 10 10 10 10 10 10 10 10 10 10 10 10 10 10 10
10 10 10 10 10 10 10 10 10 10 10 10 10 10 10 10 10 10 10 10 10 34 14 14 14 30 10 10 10 10 10 10 10 10 10 10 10 10 10 10 10 10 10 10 10 10 10 10 10 10
10 10 10 10 10 10 10 10 10 10 10 10 10 10 10 10 10 10 10 10 10 34 14 14 14 30 10 10 10 10 10 10 10 10 10 10 10 10 10 10 10 10 10 10 10 10 10 10 10 10
10 10 10 10 10 10 10 10 10 10 10 10 10 10 10 10 10 10 10 10 10 34 14 14 14 31 10 10 10 10 10 10 10 10 10 10 10 10 10 10 10 10 10 10 10 10 10 10 10 10
10 10 10 10 10 10 10 10 10 10 10 10 10 10 10 10 10 10 10 10 10 10 35 14 14 14 30 10 10 10 10 10 10 10 10 10 10 10 10 10 10 10 10 10 10 10 10 10 10 10
10 10 10 10 10 10 10 10 10 10 10 10 10 10 10 10 10 10 10 10 10 10 34 14 14 14 31 10 10 10 10 10 10 10 10 10 10 11 11 11 11 11 11 11 11 11 11 11 11 11
10 10 10 10 10 10 10 10 10 10 10 10 10 10 10 10 10 10 10 10 10 10 10 35 14 14 14 31 10 10 10 10 10 10 10 10 10 11 10 10 10 10 10 10 10 10 10 10 10 11
10 10 10 10 10 10 10 10 10 10 10 10 10 10 10 10 10 10 10 10 10 10 10 10 35 14 14 14 31 32 10 10 10 10 10 10 10 11 10 11 11 11 11 11 11 11 11 11 10 11
10 10 10 10 10 10 10 10 10 10 10 10 10 10 10 10 10 10 10 10 10 10 10 10 10 35 14 14 14 14 31 32 32 10 10 10 10 11 10 11 10 10 10 10 10 10 10 10 10 11
10 10 10 10 10 10 10 10 10 10 10 10 10 10 10 10 10 10 10 10 10 10 10 10 10 10 35 14 14 14 14 14 14 31 32 32 10 11 10 11 10 11 11 11 11 11 11 11 11 11
10 10 10 10 10 10 10 10 10 10 10 10 10 10 10 10 10 10 10 10 10 10 10 10 10 10 10 35 14 14 14 14 14 14 14 14 30 10 10 11 10 10 10 10 10 10 10 10 10 11
10 10 10 10 10 10 10 10 10 10 10 10 10 10 10 10 10 10 10 10 10 10 10 10 10 10 10 10 28 35 14 14 14 14 14 14 30 11 11 11 11 11 11 11 11 11 11 11 11 11